######...###
#..###....##
...#....####
#.........##
..######..##
....@##...##
##....##..##
........####
#####.....##
......####..
######......